1,1,3,1,2,2
1,2,4,4,4,1
5,5,6,5,7,3
4,1,1,4,3,1
1,2,1,1,4,0
3,1,3,4,4,2
